#############
##.####....D#
#..#..##.####
##...P##..D##
#...###..#.##
#.#D.......##
#.#.##..#..##
#......##.###
##...##@#..##
#..D##.....##
#############