######...##
#@.#...#.##
##..#.##...#
##.#..#.##.#
#......#...#
####..###..#
#.#..#..#.##
##...##.#..#
#..#.#..##.#
#.....#.#.P#
###########