#############
#..D...#....#
D....#......D
###.#....#..#
##.....##...#
##.####...#.#
#.P.#.....#.#
####...#.####
#....###...##
#..@##...#..#
########D####