###########D#
#..@#..#....#
#D.....#....#
#####.###.#.#
#####.....#.#
##..#######.#
D......#....#
####.#...####
#....########
##D#.....P..#
#############