#############
#......#....#
D....#.....D#
###.#.##..#.#
###....P#.#.#
##.######.#.#
#.D.......#.#
##.#.#.#.####
#....###.####
##D##@......#
#############